{
    "levels" : [
        {
            "id" : 1,
            "rows" : [
                "    *                    X  ",
                "#######H#######          X  ",
                "       H----------     * X  ",
                "       H    ##H   #######H##",
                "       H    ##H          H  ",
                "     E H    ##H      * E H  ",
                "##H#####    ########H#######",
                "  H                 H       ",
                "  H           E     H       ",
                "#########H##########H       ",
                "         H          H       ",
                "       * H----------H    *  ",
                "    H######         #######H",
                "    H        P    *        H",
                "############################"
            ]
        }
    ]
}