{
    "rows" : [
        "0000*00000000000000000000000",
        "#######H#######0000000000000",
        "0000000H----------00000*0000",
        "0000000H0000##H000#######H##",
        "0000000H0000##H0000000000H00",
        "00000E0H0000##H0000000*E0H00",
        "##H#####0000########H#######",
        "00H00000000000000000H0000000",
        "00H00000000000E00000H0000000",
        "#########H##########H0000000",
        "000000000H0000000000H0000000",
        "0000000*0H----------H0000*00",
        "0000H######000000000#######H",
        "0000H00000000P0000*00000000H",
        "############################"
    ]
}